13	13	13	13	13	13	13	13	13	13	13	13	13	13	13	13	13	13	13	13
13	100	1	0	0	0	1	0	0	1	0	0	1	0	0	0	0	0	0	13
13	0	0	1	0	0	0	1	0	1	0	0	1	0	0	0	0	0	0	13
13	0	1	0	1	0	1	0	0	1	1	0	1	0	0	0	0	0	0	13
13	1	0	1	0	13	13	13	13	13	13	13	13	13	0	0	0	0	0	13
13	0	1	0	1	13	0	0	0	0	0	0	0	13	0	0	0	0	0	13
13	1	0	1	0	13	0	13	0	0	0	13	0	13	0	0	0	0	0	13
13	0	1	13	13	13	0	13	0	13	0	13	0	13	13	13	0	0	0	13
13	0	0	13	0	0	0	13	1	0	1	13	0	0	0	13	0	0	0	13
13	0	0	13	0	13	1	13	0	0	0	13	1	13	0	13	0	0	0	13
13	0	0	13	13	13	0	0	13	1	13	0	0	13	13	13	0	0	0	13
13	0	0	0	1	0	0	0	13	99	13	0	0	0	1	0	0	0	0	13
13	0	0	0	0	1	0	0	13	13	13	0	0	1	0	0	0	0	0	13
13	0	0	0	0	0	1	13	0	13	0	13	1	0	1	1	1	1	1	13
13	0	0	0	0	0	0	13	0	13	0	13	0	0	0	0	0	0	0	13
13	0	0	0	0	0	0	13	0	13	0	13	0	0	0	0	0	0	0	13
13	0	0	0	0	0	13	13	13	13	13	13	13	1	1	1	1	1	1	13
13	0	0	0	0	0	1	0	0	0	0	0	1	0	0	0	0	0	0	13
13	0	0	0	0	0	1	0	0	0	0	0	1	0	0	0	0	0	0	13
13	13	13	13	13	13	13	13	13	13	13	13	13	13	13	13	13	13	13	13
